NO ./textures/Wall/lightspeed.png
SO ./textures/Wall/lightspeed.png
WE ./textures/Wall/arrows_right.png


F 0,0,0
EA ./textures/Wall/arrows_right.png
C 0,0,0

     111111
    10100011111111111111111111111111111111111111111111111111111111111111111111111111111111111111111111111111111111111111111111111111111111111111111111111111111
    10100000000000000000000000000000000000000000000000000000000000000000000000000000000000000000000000000000000000000000000000000000000000000000000000000000001
    10100000000000000000000000000000000000000000000000000000000000000000000000000000000000000000000000000000000000000000000000000000000000000000000000000000001
    10000000000000000000000000000000000000000000000000000000000000000000000000000000000000000000000000000000000000000000000000000000000000000000000000000000001
    100E0011111111111111111111111111111111111111111111111111111111111111111111111111111111111111111111111111111111111111111111111111111111111111111111100000001
    1100011                                                                                                                                           100000001
     11011                                                                                                                                            100000001
     10001                                                                                                                                            100000001
     11011                                                                                                                                            100000001
     10001                                  1111111                                                                                                   100000001                                                                                                    
 111111011111111111111111111             1110000000111                                                                                                100000001
10000000000000000000000000001         111000000000000011                                                                                              100000001
10000000000000000000000000111       11000000000000000001                                                                                              100000001
10000000000000000000000000000111111100000000000000000001                                                                                              100000001
 11110000000000001111110000000000000000000000000000000001111111111111111111111111111111111111111111111111111111111111111111111111111111111111111111111100000000111111111111111111
    1000000000001   1000000000000000000000000000000000000000000000000000000000000000000000000000000000000000000000000000000000000000000000000000000000000000000000000000000000001
    1000000000001   1000000000000000000000000000000000000000000000000000000000000000000000000000000000000000000000000000000000000000000000000000000000000000000000000000000001001
    1000000000001   1000000000000000000000000000000000000000000000000000000000000000000000000000000000000000000000000000000000000000000000000000000000000000000000000000000000001
    1000000000001   1000000000000000000000000000000000001111111111111111111111111111111111111111111111111111111111111111111111111111111111111111111111100000011111111111100000001
    1000000000001   100000000111111100000000000000000001                                                                                              10000001          100000001
    10000000000001111000000111      1000000000000000001                                                                                               10000001          100000001
 111000000000000000000000001         11000000000000011                                                                                                10000001          100000001                                                                                                                   
1000000000000000100000111111           1110000000111                                                                                                  10000001          100000001
1000000111110000000001                    1100001                                                                                                     10000001          100000001
1000001     100000001111111111111111111111110000111111111111111111111111111111111111111111111111111111111111111111111111111111111111111111111111111111100000011111111111100000001
1000001     100000000000000000000000000000000000000000000000000000000000000000000000000000000000000000000000000000000000000000000000000000000000000000000000000000000000000000001
1000001     100000000000000000000000000000000000000000000000000000000000000000000000000000000000000000000000000000000000000000000000000000000000000000000000000000000000000000001
1000001     100000000000000000000000000000000000000000000000000000000000000000000000000000000000000000000000000000000000000000000000000000000000000000000000000000000000000000001
 11111       11111111111111111111111111111111111111111111111111111111111111111111111111111111111111111111111111111111111111111111111111111111111111111111111111111111111111111111