NO ./textures/Wall/Brick_05-256x256.png
SO ./textures/Ceiling/Elements_02-256x256.png
WE ./textures/Ceiling/Metal_19-256x256.png
EA ./textures/Wall/Brick_04-256x256.png

F 0,255,251
C 0,12,0

      111
     10001
    1010001
    1000011
    100E001
    1100011
     11011
     10001
     11011
     10001                                1111111
 111111011111111111111111111           1110000000111
10000000000000000000000000001        11000000000000011
10000000000000000000000000111       1000000000000000001
10000000000000000000000000000111111100000000000000000001
 11110000000000001111110000000000000000000000000000000001
    1000000000001   1000000000000000000000000000000000001
    1000000000001   100000000111111100000000000000000001
    10000000000001111000000111      1000000000000000001
 111000000000000000000000001         11000000000000011
1000000000000000100000111111           1110000000111
1000000111110000000001                    1100001
1000001     100000001       111111111111111100001
1000001     100000001       100000000000000000001
 11111       1111111        111111111111111111111