NO ./textures/wall/WoodbrickD.xpm
SO ./textures/wall/WoodbrickL.xpm
WE ./textures/wall/WoodbrickeagleL.xpm
EA ./textures/wall/WoodbrickL.xpm

F 0,255,251
C 0,12,0

111111111111111111111111111111111111111
100000000000000000000000000000000000001
100000000000000000000000000000000000001
100000000000000000000000000000000000001
100000000000000000000000000000000000001
100000000000000000000000000000000000001
100000000000000100000010000000000000001
100000000000000000000000000000000000001
100000000000000000000000000000000000001
100000100000000000000000000000000000001
100000100000000000N00000000010000000001
100000100000000000000000000000000000001
100000000000000000000000000000000000001
100000000000000000000000000000000000001
100000000000000000000000000000000000001
100000000000000100100100000000000000001
100000000000000000000000000000000000001
100000000000000000000000000000000000001
100000000000000000000000000000000000001
100000000000000000000000000000000000001
100000000000000000000000000000000000001
111111111111111111111111111111111111111