NO ./textures/wall/WoodbrickD.xpm
SO ./textures/wall/WoodbrickL.xpm
WE ./textures/wall/WoodbrickeagleL.xpm
EA ./textures/wall/WoodbrickL.xpm

F 0,255,251
C 255,12,0

      111
     11011
    1010001
    1000001
    100N001
    1100011
     11011
     10001
     11011
     10001                                1111111
 111111011111111111111111111           1110000000111
10000000000000000000000000001        11000000000000011
10010000000000000000000000111       1000000000000000001
10000000000000000000000000000111111100000000000000000001
 11110000000000001111110000000000000000000000000000000001
    1000000000001   1000000000000000000000000000000000001
    1000000000001   100000000111111100000000000000000001
    10000000000001111000000111      1000000000000000001
 111000000000000000000000001         11000000000000011
1000000000000000100000111111           1110000000111
1000000111110000000001                    1100001
1000001     100000001       111111111111111100001
1000001     100000001       100000000000000000001
 11111       1111111        111111111111111111111