NO ./textures/wall/WoodbrickD.xpm
SO ./textures/wall/WoodbrickL.xpm
WE ./textures/wall/WoodbrickeagleL.xpm
EA ./textures/wall/WoodbrickL.xpm

F 0,255,251
C 255,12,0

111111111111111111111111111111111111111
100000000000000000000000000000000000001
100000000000000000000000000000000000001
100000000000000000000000000000000000001
100000000000000000000000000000000000001
100000000000000000101010000010101010001
100000000000000000000000000000000000001
1000000000000000000000000000100W0010001
100000000000000000000000000000000000001
100000000000000000101000000010101010001
100000000000000000000000000000000000001
100000000000000000000000000000000000001
100000000000000000000000000000000000001
100000000000000000000000000000000000001
100000000000000000000000000000000000001
100000000000000000000000000000000000001
100000000000000000000000000000000000001
100000000000000000000000000000000000001
100000000000000000000000000000000000001
100000000000000000000000000000000000001
100000000000000000000000000000000000001
111111111111111111111111111111111111111